
R   500 500          

NO   ./textures/north.xpm

SO                  ./textures/south.xpm            

WE    ./textures/west.xpm           
EA    ./textures/east.xpm      


S  ./textures/sprite.xpm


F  255, 255,  255

C 50, 50, 50               



                                             111                            
11111111111                                  101
10001112001111111                            101
11100000002001111111111111111                 111
10000N0200111111011
10000002011110111
1000011221000001111111111
1200010200100001
1000000200111111
110001020011111111
100001121111000001111111111 11111 11       111111
11110002010000100000000011111101111111111
1221000201100101110000000000000022222221
111211021000000001111111111111111111111
11111111111111111111111111111111111111111111111111111


